.......................................
.......................................
.......................................
.......................................
.......................................
.......................................
.......................................
.....#############################.....
.....#...........................#.....
.....#...........................#.....
.....#...........................#.....
.....#...........................#.....
.....#...........................#.....
.....#########...........#########.....
.......................................
.......................................
.......................................
.......................................
.......................................
.......................................
.......................................
.......................................
.....#########...........#########.....
.....#...........................#.....
.....#...........................#.....
.....#...........................#.....
.....#...........................#.....
.....#...........................#.....
.....#############################.....
.......................................
.......................................
.......................................
.......................................
.......................................
.......................................
.......................................
.......................................
.......................................
.......................................