.......................................
.......................................
.......................................
.......................................
.......................................
.......................................
.......................................
.......................................
.......................................
.......................................
.......................................
.......................................
.......................................
.....##############################....
.....#.................................
.....#.................................
.....#.................................
.....#............................#....
.....#............................#....
.....#............................#....
.....#............................#....
.....#............................#....
.....#............................#....
.....#............................#....
.....#............................#....
.....#............................#....
..................................#....
..................................#....
..................................#....
.....##############################....
.......................................
.......................................
.......................................
.......................................
.......................................
.......................................
.......................................
.......................................
.......................................
.......................................